# # # # # # # # # #
# # # . . . . . . #
# # . # # . # # . #
# . # . . # . . . #
# . . . # . # . . #
# # # # . . . # O #
# # # # # # # # # #
