#############################################################
#.....#..#..............#...................................#
#..#..#..#..####..#######..################################.#
#..#...........#.....#.....#..............#..#.....#.....#..#
#######..#######.##..####..####..##########..####..####..#..#
#..#..#.....#..#.....#.....#........#........#..#........#..#
#..#..####..#..#.######.#..####..####..#..####..#######..##.#
#.....#..#..............#...........#..#........#..#.....#..#
#..####..####..#######..####..##########..####..#..####..##.#
#..#........#..#.....#..............#..#..#........#.....#..#
#..####..####..####..##########..#..#..####..#######..####..#
#..#..#..#..............#..#..#..#........#........#.....#..#
#..#..#..#..#############..#..#..####..####..####..#..####..#
#.....#........#..#..#.....#.....#..#..#.....#..#..#.....#..#
#..##########..#..#..####..#..#..#..#..#..####..#..#..####..#
#........#.................#..#.....#........#..#..#.....#..#
#..#..#######..####..#..####..####..#..#..####..####..####..#
#..#.....#.....#.....#..#.....#..#..#..#.....#........#.....#
#..####..#..#..#..####..#######..#######..####..##########..#
#..#........#..#.....#..#........#.....#..#...........#.....#
####..#######..#######..####..####..####..####..#..#######..#
#........#..#.....#..#.....#........#...........#........#..#
#..#######..#######..#..####..#..####..#..#############..##.#
#........#..#..............#..#.....#..#..#.....#..#..#..#..#
#..####..#..#..##########..#######.....#######..#..#..####..#
#..#.....#.....#.....#.....#..#..#..#..#.....#..#.....#..#..#
####..#######..#..#..#######..#..#..#######..#..####..#..#..#
#.....#.....#.....#........#..#..#..#..#...........#.....#..#
####..#..#..#..#######..####..#..#..#..#..####..#######..#..#
#.....#..#..#..#..#..#..#..#.................#...........#..#
#..#..#..#######..#..####..#..##########..##########..#..##.#
#..#.....#..#...........#..#.....#..#.....#..#.....#..#..#..#
#######..#..#..####..####..#..####..####..#..#..####..####..#
#..............#..#..#..#........#........#...........#.....#
####..####..#..#..#..#..####..#######..#######..#..#######..#
#..#..#.....#.....#..#........#..#.....#.....#..#.....#.....#
#..#..#..#############..####..#..####..#..#..####..#######..#
#.....#........#..#........####..#..#..#..####.....#........#
####..####..#..#..#..####..#..#..#..#..####.##############..#
##O.......#..#.....#.....#..#..............#................#
#############################################################
